S,G,G,G,S,S,S,S,G,G,G,S,S,S,S,S,G,G,G
S,G,G,S,S,S,S,S,S,G,G,S,S,S,S,S,S,S,G
S,G,G,G,S,S,S,S,S,G,S,S,S,S,S,S,S,S,G
S,G,S,S,S,S,S,S,S,S,S,S,S,S,S,S,S,S,S
S,G,G,S,S,S,S,S,S,S,S,S,S,S,S,S,S,S,S
S,S,S,S,S,S,S,S,S,S,S,S,F,F,F,F,F,F,F
S,F,F,F,F,F,F,F,S,S,S,S,F,L,L,F,F,F,F
S,F,F,F,F,F,F,F,S,S,S,S,S,L,L,F,S,S,S
S,C,F,F,F,F,C,S,S,S,S,S,C,F,F,L,F,S,S
S,C,F,F,F,F,C,S,S,S,S,S,C,C,L,L,F,S,S
S,L,F,F,F,F,C,S,S,S,S,S,S,L,F,L,C,S,S
S,S,L,L,L,L,L,L,S,S,S,S,S,S,S,S,S,S,S
S,S,L,L,S,S,L,S,S,S,S,S,S,S,S,S,S,S,S
S,S,S,S,S,S,S,S,S,S,F,L,S,S,S,S,S,S,S
S,S,S,S,S,S,S,S,S,C,C,F,S,S,S,S,S,S,S
S,S,S,S,S,S,S,S,L,L,L,C,S,S,S,S,S,S,S
S,S,S,S,S,S,S,F,L,L,L,S,S,S,S,S,S,S,S
S,S,S,S,S,S,S,F,L,S,L,S,S,S,S,S,S,S,S
S,S,S,S,S,S,S,F,L,L,L,S,S,S,S,S,S,S,S
S,S,S,S,S,S,S,F,L,L,S,S,S,S,S,S,S,S,S
S,S,S,S,S,S,S,F,F,F,F,S,S,S,S,S,S,S,S
S,S,S,S,S,S,S,C,F,F,S,S,S,S,S,S,S,S,S
S,S,S,S,S,S,S,S,S,S,S,S,S,S,G,G,G,G,G
S,S,S,S,S,S,S,S,S,S,S,S,S,S,G,G,G,G,G
S,S,S,S,S,S,S,S,S,S,S,S,S,S,G,G,G,G,G
